1111111111111
100C000C00001
1000P01001111
10010000E0001
1111111111111