1111111111111111111111111111111111
1E000000F000000C00000C000000000001
1001011101110111001100111110000001
1001000100000001001011010000000001
10010011001100010010000111100000C1
1P010111011100010010000100000000C1
1111111111111111111111111111111111