1111111111111111111111111111111111
1C0010C00C0000C0C0000C000T00000001
10100101101000001010011111011111C1
10100P0010111111101001000000000111
101000001C10C0000000010000000000E1
1111111111111111111111111111111111