1111111111111
10P1000000001
10C0000111101
100010E000001
1111111111111