1111111111111
100C000C00001
1000P00111101
100010000E001
1111111111111